['_default/0', None, None, None, None]
_0000_0000_0000_0000_0000_0000_0000_0000_0000_0000_0000_0000
_0000_0000_0000_0000_0000_0000_0000_0000_0000_0000_0000_0000
_0000_0000_0000_0000_0000_0000_0000_0000_0000_0000_0000_0000
_0000_0000_0000_0000_0000_0000_0000_0000_0000_0000_0000_0000
_0000_0000_0000_0000_0000_0000_0000_0000_0000_0000_0000_0000
_0000_0000_0000_0000_0000_0000_0000_0000_0000_0000_0000_0000
_0000_0000_0000_0000_0000_0000_0000_0000_0000_0000_0000_0000
_0000_0000_0000_0000_0000_0000_0000_0000_0000_0000_0000_0000
_0000_0000_0000_000000000000000000000000_0000_0000_0000_0000
_0000_0000_0000_000000000_0000_000000000_0000_0000_0000_0000
_0000_0000_0000_000000000_0000_000000000_0000_0000_0000_0000
_0000_0000_0000_000000000000000000000000_0000_0000_0000_0000
_0000_0000_0000_0000_0000_0000_0000_0000_0000_0000_0000_0000
_0000_0000_0000_0000_0000_0000_0000_0000_0000_0000_0000_0000
_0000_0000_0000_0000_0000_0000_0000_0000_0000_0000_0000_0000
_0000_0000_0000_0000_0000_0000_0000_0000_0000_0000_0000_0000
_0000_0000_0000_0000_0000_0000_0000_0000_0000_0000_0000_0000
_0000_0000_0000_0000_0000_0000_0000_0000_0000_0000_0000_0000
_0000_0000_0000_0000_0000_0000_0000_0000_0000_0000_0000_0000
_0000_0000_0000_0000_0000_0000_0000_0000_0000_0000_0000_0000
_0000_0000_0000_0000_0000_0000_0000_0000_0000_0000_0000_0000
_0000_0000_0000_0000_0000_0000_0000_0000_0000_0000_0000_0000
_0000_0000_0000_0000_0000_0000_0000_0000_0000_0000_0000_0000
_0000_0000_0000_0000_0000_0000_0000_0000_0000_0000_0000_0000