['_default/0', None, None, None, None]
000000000000000000000000000000000000000000000000000000000000
00000_0000_0000_0000_0000_0000_0000_0000_0000_0000_000000000
00000_0000_0000_0000_0000_0000_0000_0000_0000_0000_000000000
00000_0000_0000_0000_0000_0000_0000_0000_0000_0000_000000000
00000_0000_0000_0000_0000_0000_0000_0000_0000_0000_000000000
00000_000000000000000000000000000000000000000_0000_000000000
00000_0000_0000_0000_0000_0000_0000_0000_0000_0000_000000000
00000_0000_0000_0000_0000_0000_0000_0000_0000_0000_000000000
00000_0000_0000_0000_0000_0000_0000_0000_0000_0000_000000000
00000_0000_0000_0000_0000_0000_0000_0000_0000_0000_000000000
00000_0000_0000_0000_0000_0000_0000_0000_0000_0000_000000000
00000_0000_0000_0000_0000_0000_0000_0000_0000_0000_000000000
00000_0000_0000_0000_0000_0000_0000_0000_0000_0000_000000000
00000_0000_0000_0000_0000_0000_0000_0000_0000_0000_000000000
00000_0000_0000_0000_0000_0000_0000_0000_0000_0000_000000000
00000_0000_0000_0000_0000_0000_0000_0000_0000_0000_000000000
00000_0000_0000_0000_0000_0000_0000_0000_0000_0000_000000000
00000_0000_0000_0000_0000_0000_0000_0000_0000_0000_000000000
00000_0000_0000_0000_0000_0000_0000_0000_0000_0000_000000000
00000_0000_0000_0000_0000_0000_0000_0000_0000_0000_000000000
00000_0000_0000_0000_0000_0000_0000_0000_0000_0000_000000000
00000_0000_0000_0000_0000_0000_0000_0000_0000_0000_000000000
00000_0000_0000_0000_0000_0000_0000_0000_0000_0000_000000000
000000000000000000000000000000000000000000000000000000000000