['_default/0', None, None, None, None]
000000000000000000000000000000000000000000000000000000000000
000000000000000_0000_0000_0000_0000_0000_0000010000000000000
000000000000000_0000_0000_0000_0000_0000_0000011000000000000
00000_0000_0000_0000_0000_0000_0000_0000_0000012000000000000
00000_0000_0000_0000_0000_0000_0000_0000_0000_00000000000000
00000_0000_0000_0000_0000_0000_0000_0000_0000_00000000000000
00000_0000_0000_0000_0000_0000_0000_0000_0000_00000000000000
00000_0000_0000_0000_0000_0000_0000_0000_0000_00000000000000
00000_0000_0000_0000_0000_0000_0000_0000_0000_00000000000000
00000_0000_0000_0000_0000_0000_0000_0000_0000_00000000000000
00000_0000_0000_0000_0000_0000_0000_0000_0000_00000000000000
00000_0000_0000_0000_0000_0000_0000_0000_0000_00000000000000
00000_0000_0000_0000_0000_0000_0000_0000_0000_00000000000000
00000_0000_0000_0000_0000_0000_0000_0000_0000_00000000000000
00000_0000_0000_0000_0000_0000_0000_0000_0000_00000000000000
00000_0000_0000_0000_0000_0000_0000_0000_0000_00000000000000
00000_0000_0000_0000_0000_0000_0000_0000_0000_00000000000000
00000_0000_0000_0000_0000_0000_0000_0000_0000_00000000000000
00000_0000_0000_0000_0000_0000_0000_0000_0000_00000000000000
00000_0000_0000_0000_0000_0000_0000_0000_0000_00000000000000
00000_0000_0000_0000_0000_0000_0000_0000_0000007000000000000
000000000000000_0000_0000_0000_0000_0000_0000008000000000000
000000000000000_0000_0000_0000_0000_0000_0000009000000000000
000000000000000000000000000000000000000000000000000000000000