[None, None, None, None, None]
_0000_0000_0000_0000_0000_0000_0000_0000_0000_0000_0000_0000
_0000_0000_0000_0000_0000_0000_0000_0000_0000_0000_0000_0000
_0000_0000_0000_0000_0000_0000_0000_0000_0000_0000_0000_0000
_0000_0000_0000_0000_0000_0000_0000_0000_0000_0000_0000_0000
_0000_0000_0000_0000_0000_0000_0000_0000_0000_0000_0000_0000
_0000_0000_0000_0000_0000_0000_0000_0000_0000_0000_0000_0000
_0000_0000_0000_0000_0000_0000_0000_0000_0000_0000_0000_0000
_0000_0000_0000_0000_0000_0000_0000_0000_0000_0000_0000_0000
_0000_0000_0000_0000_0000_0000_0000_0000_0000_0000_0000_0000
_0000_0000_0000_0000_0000_0000_0000_0000_0000_0000_0000_0000
_0602_0603_0604_0605_0606_0606_0000_0000_0000_0000_0000_0000
_0603_0604_0605_0606_0706_0706_0000_0000_0000_0000_0000_0000
_0703_0704_0705_0706_0806_0806_0000_0000_0000_0000_0000_0000
_0603_0604_0605_0606_0906_0906_0000_0000_0000_0000_0000_0000
_0603_0604_0605_0606_1006_1006_0606_0000_0000_0000_0000_0000
_0703_0704_0705_0706_1106_1106_0706_0000_0000_0000_0000_0000
_0803_0804_0805_0806_1105_1106_0806_0000_0000_0000_0000_0000
_0603_0604_0605_0606_1105_1106_0906_0000_0000_0000_0000_0000
_0703_0704_0705_0706_1105_1106_1006_0000_0000_0000_0000_0000
_0603_0604_0605_0606_1104_1105_1106_0000_0000_0000_0000_0000
_0604_0605_0606_0706_1004_1005_1006_0606_0000_0000_0000_0000
_0704_0705_0706_0806_1104_1105_1106_0706_0000_0000_0000_0000
_0804_0805_0806_0906_1004_1005_1006_0806_0000_0000_0000_0000
_0603_0604_0605_0606_1104_1105_1106_0906_0000_0000_0000_0000