['_default/2', None, None, None, None]
000000000000000_0000_0000_0000_0000_0000_0000_0000_0000_0000
000000000000000_0000_0000_0000_0000_0000_0000_0000_0000_0000
000000000000000_0000_0000_0000_0000_0000_0000_0000_0000_0000
00000_0000_0000_0000_0000_0000_0000_0000_0000_0000_0000_0000
00000_0000_0000_0000_0000_0000_0000_0000_0000_0000_0000_0000
00000_0000_0000_0000_0000_0000_0000_0000_0000_0000_0000_0000
00000_0000_0000_0000_0000_0000_0000_0000_0000_0000_0000_0000
_0000_0000_0000_0000_0000_0000_0000_0000_0000_0000_0000_0000
_0000_0000_0000_0000_0000_0000_0000_0000_0000_0000_0000_0000
_0000_0000_0000_0000_0000_0000_0000_0000_0000_0000_0000_0000
_0000_0000_0000_0000_0000_0000_0000_0000_0000_0000_0000_0000
_0000_0000_0000_0000_0000_0000_0000_0000_0000_0000_0000_0000
_0000_0000_0000_0000_0000_0000_0000_0000_0000_0000_0000_0000
_0000_0000_0000_0000_0000_0000_0000_0000_0000_0000_0000_0000
_0000_0000_0000_0000_0000_0000_0000_0000_0000_0000_0000_0000
_0000_0000_0000_0000_0000_0000_0000_0000_0000_0000_0000_0000
_0000_0000_0000_0000_0000_0000_0000_0000_0000_0000_0000_0000
_0000_0000_0000_0000_0000_0000_0000_0000_0000_0000_0000_0000
_0000_0000_0000_0000_0000_0000_0000_0000_0000_0000_0000_0000
_0000_0000_0000_0000_0000_0000_0000_0000_0000_0000_0000_0000
_0000_0000_0000_0000_0000_0000_0000_0000_0000_0000_0000_0000
_0000_0000_0000_0000_0000_0000_0000_0000_0000_0000_0000_0000
_0000_0000_0000_0000_0000_0000_0000_0000_0000_0000_0000_0000
_0000_0000_0000_0000_0000_0000_0000_0000_0000_0000_0000_0000