['_default/0', '_default/3', '_default/4', '_default/5', '_default/2']
000000000000000000000000000000000000000000000000000000000000
00000_0000_0000_0000_0000_0000_0000_0000_0000000000000000000
000004000040000400004000040000400004000040000000000000000000
00000_0000_0000_00002000020000_0000_0000_0000000000000000000
00000_0000_0000_00002000020000_0000_0000_0000000000000000000
00000_0000_0000_00002000020000_0000_0000_0000000000000000000
00000_0000_000010000100001000010000_0603_0604000000000000000
00000_0000_060210000200002000010000_0603_0604000000000000000
00000_0000_070210000200002000010000_0603_0604000000000000000
00000_0000_080210000200002000010000_0604_0605000000000000000
000003000030000100002000020000100003000030000000000000000000
000003000030000100003000030000100003000030000000000000000000
000003000030000100003000030000100003000030000000000000000000
000003000030000100002000020000100003000030000000000000000000
00000_0000_090210000200002000010000_0806_0606000000000000000
00000_0000_100210000200002000010000_0906_0706000000000000000
00000_0000_110210000200002000010000_0605_0606000000000000000
00000_0000_110210000100001000010000_0705_0706000000000000000
00000_0000_1102_11032000020000_0804_0805_0806000000000000000
00000_0000_1102_11032000020000_0603_0604_0605000000000000000
00000_0000_1102_11032000020000_0703_0704_0705000000000000000
000004000040000400004000040000400004000040000000000000000000
00000_0000_0000_0000_0702_0902_0602_0603_0604000000000000000
000000000000000000000000000000000000000000000000000000000000