[None, None, None, None, None]
_0000_0000_0000_0702_0902_1102_0802_0602_0603_0604_0605_0606
_0000_0000_0602_0802_1002_1003_0902_0702_0703_0704_0705_0706
_0000_0000_0702_0902_1102_1103_1002_0602_0603_0604_0605_0606
_0000_0000_0802_1002_1102_1103_1102_0602_0603_0604_0605_0606
_0000_0000_0902_1102_1103_1104_1105_0702_0602_0603_0604_0605
_0000_0000_1002_1102_1103_1104_1105_0802_0702_0703_0704_0705
_0000_0000_1102_1102_1103_1104_1105_0902_0802_0803_0804_0805
_0000_0000_1102_1103_1104_1105_1106_1002_0902_0903_0904_0905
_0000_0000_0000_1102_1103_1104_1105_1102_1002_1003_1004_1005
_0000_0000_0000_0000_0000_1102_1103_1104_1102_1103_1104_1105
_0000_0000_0000_0000_0000_0000_0000_0000_1102_1103_1104_1105
_0000_0000_0000_0000_0000_0000_0000_0000_0000_0000_0000_0000
_0000_0000_0000_0000_0000_0000_0000_0000_0000_0000_0000_0000
_0000_0000_0000_0000_0000_0000_0000_0000_0000_0000_0000_0000
_0000_0000_0000_0000_0000_0000_0000_0000_0000_0000_0000_0000
_0000_0000_0000_0000_0000_0000_0000_0000_0000_0000_0000_0000
_0000_0000_0000_0000_0000_0000_0000_0000_0000_0000_0000_0000
_0000_0000_0000_0000_0000_0000_0000_0000_0000_0000_0000_0000
_0000_0000_0000_0000_0000_0000_0000_0000_0000_0000_0000_0000
_0000_0000_0000_0000_0000_0000_0000_0000_0000_0000_0000_0000
_0000_0000_0000_0000_0000_0000_0000_0000_0000_0000_0000_0000
_0000_0000_0000_0000_0000_0000_0000_0000_0000_0000_0000_0000
_0000_0000_0000_0000_0000_0000_0000_0000_0000_0000_0000_0000
_0000_0000_0000_0000_0000_0000_0000_0000_0000_0000_0000_0000