[None, None, None, None, None]
_0703_0704_0705_0706_1104_1105_1106_1006_0000_0000_0000_0000
_0603_0604_0605_0606_1103_1104_1105_1106_0000_0000_0000_0000
_0603_0604_0605_0606_1003_1004_1005_1006_0000_0000_0000_0000
_0604_0605_0606_0606_1103_1104_1105_1106_0000_0000_0000_0000
_0606_0606_0606_0706_1003_1004_1005_1006_0000_0000_0000_0000
_0706_0706_0706_0806_1103_1104_1105_1106_0000_0000_0000_0000
_0806_0806_0806_0906_1103_1104_1105_1106_0000_0000_0000_0000
_0906_0906_0906_1006_1003_1004_1005_1006_0000_0000_0000_0000
_1006_1006_1006_1106_1103_1104_1105_1106_0000_0000_0000_0000
_1106_1106_1106_1102_1103_1104_1105_1106_0000_0000_0000_0000
_1106_0000_0000_1102_1103_1104_1105_1106_0000_0000_0000_0000
_0000_0000_0000_1102_1103_1104_1105_1106_0000_0000_0000_0000
_0000_0000_0000_1102_1103_1104_1105_1106_0000_0000_0000_0000
_0000_0000_0000_1102_1103_1104_1105_1106_0000_0000_0000_0000
_0000_0000_0000_0000_0000_0000_0000_0000_0000_0000_0000_0000
_0000_0000_0000_0000_0000_0000_0000_0000_0000_0000_0000_0000
_0000_0000_0000_0000_0000_0000_0000_0000_0000_0000_0000_0000
_0000_0000_0000_0000_0000_0000_0000_0000_0000_0000_0000_0000
_0000_0000_0000_0000_0000_0000_0000_0000_0000_0000_0000_0000
_0000_0000_0000_0000_0000_0000_0000_0000_0000_0000_0000_0000
_0000_0000_0000_0000_0000_0000_0000_0000_0000_0000_0000_0000
_0000_0000_0000_0000_0000_0000_0000_0000_0000_0000_0000_0000
_0000_0000_0000_0000_0000_0000_0000_0000_0000_0000_0000_0000
_0000_0000_0000_0000_0000_0000_0000_0000_0000_0000_0000_0000